2111111111111111111111112
1000000000000000000000001
1000000000000000000000001
1000000000000000000000001
1000111111111111111110001
1000000000001000000000001
1000000000001000000000001
1000000000001000000000001
1000000000001000000000001
1000000000001000000000001
1000000000001000000000001
1000000000001000000000001
1000111111112111111110001
1000000000001000000000001
1000000000001000000000001
1000000000001000000000001
1000000000001000000000001
1000000000001000000000001
1000000000001000000000001
1000000000001000000000001
1000111111111111111110001
1000000000000000000000001
1000000000000000000000001
1000000000000000000000001
2111111111111111111111112