2111111111112111111111112
1000000000001000000000001
1000000000001000000000001
1000000000001000000000001
1000000000000000000000001
1000000000000000000000001
1000000000000000000000001
1000000000000000000000001
1000000000000000000000001
1000000000000000000000001
1000000000001000000000001
1000000000001000000000001
2111000000112110000001112
1000000000001000000000001
1000000000001000000000001
1000000000000000000000001
1000000000000000000000001
1000000000000000000000001
1000000000000000000000001
1000000000000000000000001
1000000000000000000000001
1000000000001000000000001
1000000000001000000000001
1000000000001000000000001
2111111111112111111111112