2111111111111111111111112
1000000000000000000000001
1000000000000000000000001
1000000000000000000000001
1000000000001000000000001
1000011110001000111100001
1000010000001000000100001
1000010000001000000100001
1000010000001000000100001
1000000000001000000000001
1000000000001000000000001
1000000000001000000000001
1000111111112111111110001
1000000000001000000000001
1000000000001000000000001
1000000000001000000000001
1000010000001000000100001
1000010000001000000100001
1000010000001000000100001
1000011110001000111100001
1000000000001000000000001
1000000000000000000000001
1000000000000000000000001
1000000000000000000000001
2111111111111111111111112